NO ./path_to_the_north_texture

SO      5m'                                          


WE                                       ./path_to_the_west_texture
 
C 0,10, 105
F 254,4,30



EA ./path_to_the_east_texture   

1111111111111111111111111111111111111      
10011111111111111111111111111111111N1    
1011111111111111111111111111111111111
1000011111111111111111111111111111111
1011111111111111111111111111111111111
1001111111111111111111111111111111111  11
10111111111111111111000000000000001111
100011101101111111111111111111111111
101111111111101011111111111111111 11111
100111111111111111111111111111111111101
101111111111101011111111111111111111000111
101111111111111111111111111111100000010001
100000000111111111111111111111111111111111
11111111111111111111111111111
