NO ./path_to_the_north_texture

SO      5m'                                          


WE                                       ./path_to_the_west_texture
 
C 0,10, 105
F 254,4,30



EA ./path_to_the_east_texture   

111111111111111
1000N111000001
10100000000001   1
100110000000001 101
10011001000001   1
10000001000001
100000010000011111
1010100100000000001
1000000100000000001
10101001000001000001
10000001000001000001
11111111111111111111
