NO ./sprites/wall_test2.xpm
SO ./sprites/wall_test3.xpm                                      
WE ./sprites/wall_test.xpm
EA ./sprites/wall_test4.xpm
 
C 180,250, 250
F 120,130,130

111111111111111
10000111000001
10100000000001   1
100110000000001 101
10011001000001   1
10000001000001
1000000100000111111111111111111111111111111111111111111111111111111111111111111111111111111111
10101001000000000000000000000000000000000000000000000001
10000001000000000000000000000000000000000000000000000001
10101001000000000000000000000000000000000000000000100001
100000010000000000000000000000000000000000000000001000001
101010010N0000000000000000000000000000000000000000000001
10000001000000000000000000000000000000000000000000000001
10101001000000000000000000000000000000000000000000100001
100000010000000000000000000000000000000000000000001000001
10101001000000000000000000000000000000000000000000000001
10000001000000000000000000000000000000000000000000000001
10101001000000000000000000000000000000000000000000100001
100000010000000000000000000000000000000000000000001000001
100000010000000000000000000000000000000000000000001000001
100000010000000000000000000000000000000000000000001000001
100000010000000000000000000000000000000000000000001000001
100000010000000000000000000000000000000000000000001000001
100000010000000000000000000000000000000000000000001000001
100000010000000000000000000000000000000000000000001000001
100000010000000000000000000000000000000000000000001000001
100000010000000000000000000000000000000000000000001000001
100000010000000000000000000000000000000000000000001000001
100000010000000000000000000000000000000000000000001000001
100000010000000000000000000000000000000000000000001000001
11111111111111111111111111111111111111111111111111111111111
