NO ./path_to_the_north_texture

SO      5m'                                          


WE                                       ./path_to_the_west_texture
 
C 	255				      ,255,10
F 254,4,30



EA ./path_to_the_east_texture   
        11111111111111111111111111111      
        10000000001100111000000011111    
        11110000011100000000000011111
        10010000000000000000000011111   
1111111110110000011100000000000011111
1000000000110000011101111111111111111
11110111111111011100000010001 1
111101111111110111010100100011N1
11000000110101011100000010001 1
10000000000000001100000010001
10000000000000001101010010001
11111111111111111111111111111
